#,S,#,,#
#,,,#,#
#,,,#,#
#,,,#,#
#,,G,#,#
